#time,date,susceptible,exposed,infectious,recovered,dead,immune,num infections today,num hospitalisations today,hospital bed occupancy,num hospitalisations today (data),cum num hospitalisations today,cum num infections today
1,2/3/2020,687927,1766,1429,896,1,0,491,5,18,0.0,5,491
2,3/3/2020,687284,1993,1655,1086,1,0,643,7,25,0.0,12,1134
3,4/3/2020,686560,2304,1855,1299,1,0,725,9,33,0.0,21,1859
4,5/3/2020,685755,2585,2148,1529,2,0,805,8,37,0.0,29,2664
5,6/3/2020,684792,2973,2441,1811,2,0,963,12,49,0.0,41,3627
6,7/3/2020,683697,3431,2724,2165,2,0,1095,12,60,0.0,53,4722
7,8/3/2020,682541,3820,3109,2547,2,0,1156,16,73,0.0,69,5878
8,9/3/2020,681297,4243,3456,3016,7,0,1244,18,83,0.0,87,7122
9,10/3/2020,679836,4743,3923,3506,11,0,1462,14,88,0.0,101,8584
10,11/3/2020,678212,5297,4443,4051,16,0,1624,26,109,0.0,127,10208
11,12/3/2020,676368,5957,5008,4669,17,0,1844,16,118,0.0,143,12052
12,13/3/2020,674984,6053,5602,5360,20,0,1384,23,132,0.0,166,13436
13,14/3/2020,673463,6127,6242,6166,21,0,1521,29,148,0.0,195,14957
14,15/3/2020,671823,6303,6796,7069,28,0,1641,27,160,0.0,222,16598
15,16/3/2020,670124,6453,7335,8076,31,0,1699,36,181,0.0,258,18297
16,17/3/2020,668652,6317,7831,9186,33,0,1472,36,205,0.0,294,19769
17,18/3/2020,667141,6265,8151,10425,37,0,1511,51,229,0.0,345,21280
18,19/3/2020,665591,6193,8495,11696,44,0,1551,46,257,0.0,391,22831
19,20/3/2020,663972,6293,8595,13107,52,0,1619,45,280,0.0,436,24450
20,21/3/2020,662788,5873,8752,14545,61,0,1184,42,298,0.0,478,25634
21,22/3/2020,661547,5588,8837,15980,67,0,1242,63,332,0.0,541,26876
22,23/3/2020,660364,5317,8838,17424,76,0,1183,75,371,0.0,616,28059
23,24/3/2020,659764,4516,8659,18996,84,0,601,76,408,0.0,692,28660
24,25/3/2020,659131,3927,8452,20417,92,0,633,103,470,0.0,795,29293
25,26/3/2020,658531,3338,8097,21948,105,0,600,99,531,0.0,894,29893
26,27/3/2020,658014,2902,7587,23397,119,0,517,83,570,0.0,977,30410
27,28/3/2020,657439,2573,7078,24793,136,0,575,81,596,0.0,1058,30985
28,29/3/2020,656947,2322,6478,26120,152,0,493,67,607,0.0,1125,31478
29,30/3/2020,656525,2141,5895,27287,171,0,422,89,634,0.0,1214,31900
30,31/3/2020,656129,1938,5368,28395,189,0,396,84,639,0.0,1298,32296
31,1/4/2020,655725,1799,4842,29443,210,0,404,79,644,0.0,1377,32700
32,2/4/2020,655403,1637,4384,30362,233,0,322,77,638,0.0,1454,33022
33,3/4/2020,655108,1484,3989,31184,254,0,295,62,624,0.0,1516,33317
34,4/4/2020,654837,1325,3667,31913,277,0,272,65,600,0.0,1581,33589
35,5/4/2020,654565,1210,3384,32556,304,0,272,65,586,0.0,1646,33861
36,6/4/2020,654329,1125,3059,33185,321,0,236,57,576,0.0,1703,34097
37,7/4/2020,654103,1070,2752,33747,347,0,226,57,547,0.0,1760,34323
38,8/4/2020,653894,1024,2522,34212,367,0,209,41,513,0.0,1801,34532
39,9/4/2020,653696,934,2343,34654,392,0,198,50,485,0.0,1851,34730
40,10/4/2020,653502,896,2164,35045,412,0,194,36,457,0.0,1887,34924
41,11/4/2020,653353,788,2023,35426,429,0,149,37,426,0.0,1924,35073
42,12/4/2020,653168,752,1832,35821,446,0,185,36,386,0.0,1960,35258
43,13/4/2020,653024,682,1694,36152,467,0,145,26,350,0.0,1986,35403
44,14/4/2020,652876,662,1573,36423,485,0,148,36,338,0.0,2022,35551
45,15/4/2020,652759,607,1460,36690,503,0,117,21,310,0.0,2043,35668
46,16/4/2020,652621,580,1358,36933,527,0,138,23,268,0.0,2066,35806
47,17/4/2020,652501,551,1269,37160,538,0,120,28,255,0.0,2094,35926
48,18/4/2020,652394,511,1211,37357,546,0,107,21,234,0.0,2115,36033
49,19/4/2020,652295,493,1081,37599,551,0,99,12,212,0.0,2127,36132
50,20/4/2020,652222,442,982,37805,568,0,73,15,181,0.0,2142,36205
51,21/4/2020,652151,390,934,37963,581,0,71,14,163,0.0,2156,36276
52,22/4/2020,652078,346,861,38146,588,0,73,7,148,0.0,2163,36349
53,23/4/2020,652025,322,780,38293,599,0,53,12,139,0.0,2175,36402
54,24/4/2020,651973,279,717,38444,606,0,52,9,123,0.0,2184,36454
55,25/4/2020,651918,253,662,38576,610,0,55,15,117,0.0,2199,36509
56,26/4/2020,651874,220,614,38697,614,0,44,10,116,0.0,2209,36553
57,27/4/2020,651832,206,542,38819,620,0,42,6,99,0.0,2215,36595
58,28/4/2020,651802,179,499,38911,628,0,30,11,90,0.0,2226,36625
59,29/4/2020,651770,159,463,38992,635,0,32,4,76,0.0,2230,36657
60,30/4/2020,651745,141,423,39069,641,0,25,10,75,0.0,2240,36682
61,1/5/2020,651712,136,384,39145,642,0,34,5,72,0.0,2245,36716
62,2/5/2020,651689,123,344,39218,645,0,23,6,66,0.0,2251,36739
63,3/5/2020,651665,114,312,39280,648,0,24,7,66,0.0,2258,36763
64,4/5/2020,651649,102,279,39339,650,0,16,8,65,0.0,2266,36779
65,5/5/2020,651630,99,248,39391,651,0,20,6,58,0.0,2272,36799
66,6/5/2020,651619,84,226,39436,654,0,11,4,51,0.0,2276,36810
67,7/5/2020,651599,73,215,39477,655,0,20,3,47,0.0,2279,36830
68,8/5/2020,651576,69,199,39518,657,0,23,1,38,0.0,2280,36853
69,9/5/2020,651560,66,187,39548,658,0,17,1,33,0.0,2281,36870
70,10/5/2020,651536,72,171,39580,660,0,24,6,33,0.0,2287,36894
71,11/5/2020,651521,69,158,39609,662,0,15,5,34,0.0,2292,36909
72,12/5/2020,651511,66,144,39636,662,0,10,2,32,0.0,2294,36919
73,13/5/2020,651497,65,136,39656,665,0,14,3,30,0.0,2297,36933
74,14/5/2020,651484,57,134,39679,665,0,13,2,27,0.0,2299,36946
75,15/5/2020,651471,60,122,39699,667,0,13,0,23,0.0,2299,36959
76,16/5/2020,651459,49,132,39712,667,0,12,0,20,0.0,2299,36971
77,17/5/2020,651447,51,121,39732,668,0,12,4,21,0.0,2303,36983
78,18/5/2020,651434,56,106,39754,669,0,14,1,17,0.0,2304,36997
79,19/5/2020,651421,55,101,39770,672,0,13,1,15,0.0,2305,37010
80,20/5/2020,651409,52,99,39787,672,0,12,0,12,0.0,2305,37022
81,21/5/2020,651398,46,97,39804,674,0,11,1,8,0.0,2306,37033
82,22/5/2020,651390,42,95,39818,674,0,8,2,9,0.0,2308,37041
83,23/5/2020,651380,42,80,39842,675,0,10,2,9,0.0,2310,37051
84,24/5/2020,651372,38,77,39857,675,0,8,1,10,0.0,2311,37059
85,25/5/2020,651364,40,70,39870,675,0,8,0,9,0.0,2311,37067
86,26/5/2020,651360,36,61,39886,676,0,4,0,7,0.0,2311,37071
87,27/5/2020,651351,39,56,39896,677,0,11,0,5,0.0,2311,37082
88,28/5/2020,651343,36,54,39909,677,0,8,0,3,0.0,2311,37090
89,29/5/2020,651339,30,54,39919,677,0,5,1,4,0.0,2312,37095
90,30/5/2020,651327,35,50,39930,677,0,12,0,4,0.0,2312,37107
91,31/5/2020,651319,36,49,39937,678,0,8,1,4,0.0,2313,37115
92,1/6/2020,651313,34,47,39947,678,0,6,0,4,0.0,2313,37121
93,2/6/2020,651307,32,45,39957,678,0,6,0,3,0.0,2313,37127
94,3/6/2020,651296,36,41,39968,678,0,11,0,2,0.0,2313,37138
95,4/6/2020,651292,33,42,39974,678,0,6,0,1,0.0,2313,37144
96,5/6/2020,651285,28,47,39981,678,0,7,0,1,0.0,2313,37151
97,6/6/2020,651281,26,44,39990,678,0,4,0,1,0.0,2313,37155
98,7/6/2020,651275,26,46,39994,678,0,6,0,1,0.0,2313,37161
99,8/6/2020,651268,25,51,39997,678,0,8,0,1,0.0,2313,37169
100,9/6/2020,651263,25,47,40006,678,0,8,0,0,0.0,2313,37177
101,10/6/2020,651253,27,49,40012,678,0,10,2,2,0.0,2315,37187
102,11/6/2020,651250,27,46,40018,678,0,4,0,2,0.0,2315,37191
103,12/6/2020,651244,29,43,40025,678,0,7,0,2,0.0,2315,37198
104,13/6/2020,651237,30,38,40036,678,0,8,1,3,0.0,2316,37206
105,14/6/2020,651230,28,39,40044,678,0,8,0,3,0.0,2316,37214
106,15/6/2020,651221,28,40,40052,678,0,9,0,2,0.0,2316,37223
107,16/6/2020,651214,27,44,40055,679,0,8,0,1,0.0,2316,37231
108,17/6/2020,651213,25,45,40057,679,0,3,0,1,0.0,2316,37234
109,18/6/2020,651205,26,47,40062,679,0,10,0,1,0.0,2316,37244
110,19/6/2020,651199,33,46,40062,679,0,10,0,1,0.0,2316,37254
111,20/6/2020,651190,39,41,40070,679,0,9,2,3,0.0,2318,37263
112,21/6/2020,651188,35,42,40075,679,0,6,0,3,0.0,2318,37269
113,22/6/2020,651181,28,56,40075,679,0,10,0,3,0.0,2318,37279
114,23/6/2020,651173,31,54,40082,679,0,10,0,3,0.0,2318,37289
115,24/6/2020,651164,34,51,40091,679,0,9,0,2,0.0,2318,37298
116,25/6/2020,651158,32,53,40097,679,0,7,0,2,0.0,2318,37305
117,26/6/2020,651147,39,46,40108,679,0,14,0,1,0.0,2318,37319
118,27/6/2020,651140,37,50,40113,679,0,10,0,1,0.0,2318,37329
119,28/6/2020,651140,31,51,40118,679,0,3,1,2,0.0,2319,37332
120,29/6/2020,651133,35,46,40126,679,0,8,1,3,0.0,2320,37340
121,30/6/2020,651130,36,47,40127,679,0,8,1,4,0.0,2321,37348
122,1/7/2020,651120,37,49,40134,679,0,12,0,4,0.0,2321,37360
123,2/7/2020,651111,43,46,40140,679,0,13,1,4,0.0,2322,37373
124,3/7/2020,651110,41,45,40144,679,0,5,1,5,0.0,2323,37378
125,4/7/2020,651106,40,51,40143,679,0,10,0,5,0.0,2323,37388
126,5/7/2020,651104,40,52,40144,679,0,11,1,5,0.0,2324,37399
127,6/7/2020,651104,39,53,40144,679,0,8,0,5,0.0,2324,37407
128,7/7/2020,651100,40,53,40146,680,0,11,1,4,0.0,2325,37418
129,8/7/2020,651096,40,56,40147,680,0,13,0,4,0.0,2325,37431
130,9/7/2020,651093,40,55,40151,680,0,7,0,4,0.0,2325,37438
131,10/7/2020,651088,43,57,40151,680,0,12,0,2,0.0,2325,37450
132,11/7/2020,651086,43,54,40156,680,0,9,1,3,0.0,2326,37459
133,12/7/2020,651083,48,51,40156,681,0,11,1,3,0.0,2327,37470
134,13/7/2020,651090,39,56,40153,681,0,5,1,4,0.0,2328,37475
135,14/7/2020,651092,37,58,40151,681,0,11,0,3,0.0,2328,37486
136,15/7/2020,651090,40,51,40157,681,0,9,0,3,0.0,2328,37495
137,16/7/2020,651082,47,54,40155,681,0,19,2,5,0.0,2330,37514
138,17/7/2020,651071,62,49,40156,681,0,24,1,6,0.0,2331,37538
139,18/7/2020,651062,70,61,40145,681,0,24,1,7,0.0,2332,37562
140,19/7/2020,651065,65,72,40136,681,0,12,0,7,0.0,2332,37574
141,20/7/2020,651058,80,72,40126,683,0,25,0,5,0.0,2332,37599
142,21/7/2020,651046,85,72,40133,683,0,20,1,6,0.0,2333,37619
143,22/7/2020,651037,83,89,40127,683,0,19,1,7,0.0,2334,37638
144,23/7/2020,651028,87,94,40125,685,0,23,0,5,0.0,2334,37661
145,24/7/2020,651022,96,101,40115,685,0,26,0,4,0.0,2334,37687
146,25/7/2020,651019,99,93,40123,685,0,18,0,4,0.0,2334,37705
147,26/7/2020,651017,96,97,40124,685,0,21,1,5,0.0,2335,37726
148,27/7/2020,651015,98,95,40126,685,0,21,0,4,0.0,2335,37747
149,28/7/2020,651009,96,111,40118,685,0,25,1,4,0.0,2336,37772
150,29/7/2020,650998,89,122,40125,685,0,22,1,5,0.0,2337,37794
151,30/7/2020,650993,97,126,40118,685,0,30,3,8,0.0,2340,37824
152,31/7/2020,650987,95,130,40121,686,0,24,1,7,0.0,2341,37848
153,1/8/2020,650989,90,139,40115,686,0,19,1,8,0.0,2342,37867
154,2/8/2020,650987,93,137,40115,687,0,25,1,8,0.0,2343,37892
155,3/8/2020,650976,114,138,40104,687,0,40,1,9,0.0,2344,37932
156,4/8/2020,650971,128,129,40104,687,0,35,1,9,0.0,2345,37967
157,5/8/2020,650955,137,138,40102,687,0,38,0,7,0.0,2345,38005
158,6/8/2020,650969,119,157,40086,688,0,21,2,7,0.0,2347,38026
159,7/8/2020,650977,115,158,40080,689,0,29,2,7,0.0,2349,38055
160,8/8/2020,650964,122,157,40086,690,0,30,2,6,0.0,2351,38085
161,9/8/2020,650974,124,160,40071,690,0,28,3,9,0.0,2354,38113
162,10/8/2020,650979,111,171,40068,690,0,24,1,10,0.0,2355,38137
163,11/8/2020,650985,109,171,40064,690,0,25,1,11,0.0,2356,38162
164,12/8/2020,650998,110,174,40047,690,0,30,1,11,0.0,2357,38192
165,13/8/2020,651006,112,166,40042,693,0,32,1,9,0.0,2358,38224
166,14/8/2020,651030,97,177,40022,693,0,22,3,11,0.0,2361,38246
167,15/8/2020,651018,139,151,40017,694,0,54,0,8,0.0,2361,38300
168,16/8/2020,651001,178,151,39995,694,0,61,2,10,0.0,2363,38361
169,17/8/2020,650991,186,170,39977,695,0,47,3,11,0.0,2366,38408
170,18/8/2020,650964,211,175,39974,695,0,66,1,11,0.0,2367,38474
171,19/8/2020,650961,223,190,39947,698,0,51,3,11,0.0,2370,38525
172,20/8/2020,650967,215,212,39927,698,0,48,0,11,0.0,2370,38573
173,21/8/2020,650965,206,237,39913,698,0,48,1,12,0.0,2371,38621
174,22/8/2020,650963,222,253,39882,699,0,67,3,12,0.0,2374,38688
175,23/8/2020,650971,220,273,39855,700,0,52,1,12,0.0,2375,38740
176,24/8/2020,650981,206,299,39832,701,0,51,2,12,0.0,2377,38791
177,25/8/2020,650961,223,309,39825,701,0,70,2,13,0.0,2379,38861
178,26/8/2020,650956,234,308,39820,701,0,65,2,15,0.0,2381,38926
179,27/8/2020,650953,253,297,39815,701,0,69,4,19,0.0,2385,38995
180,28/8/2020,650980,245,313,39781,700,0,53,1,19,0.0,2386,39048
181,29/8/2020,650978,252,312,39777,700,0,63,3,20,0.0,2389,39111
182,30/8/2020,650977,258,325,39758,701,0,71,1,17,0.0,2390,39182
183,31/8/2020,650999,253,343,39723,701,0,57,3,18,0.0,2393,39239
184,1/9/2020,651004,256,356,39702,701,0,72,3,17,0.0,2396,39311
185,2/9/2020,651038,240,367,39673,701,0,51,2,17,0.0,2398,39362
186,3/9/2020,651066,229,377,39645,702,0,59,4,20,0.0,2402,39421
187,4/9/2020,651103,234,367,39613,702,0,57,1,21,0.0,2403,39478
188,5/9/2020,651125,226,368,39596,704,0,51,6,25,0.0,2409,39529
189,6/9/2020,651152,241,378,39544,704,0,68,5,30,0.0,2414,39597
190,7/9/2020,651170,246,378,39520,705,0,70,4,31,0.0,2418,39667
191,8/9/2020,651213,252,378,39471,705,0,67,2,31,0.0,2420,39734
192,9/9/2020,651234,246,371,39461,707,0,58,4,30,0.0,2424,39792
193,10/9/2020,651267,248,371,39424,709,0,68,2,24,0.0,2426,39860
194,11/9/2020,651287,259,363,39401,709,0,73,1,23,0.0,2427,39933
195,12/9/2020,651315,264,375,39356,709,0,64,3,25,0.0,2430,39997
196,13/9/2020,651350,260,378,39321,710,0,62,4,25,0.0,2434,40059
197,14/9/2020,651363,275,376,39294,711,0,73,5,25,0.0,2439,40132
198,15/9/2020,651376,272,389,39271,711,0,75,4,23,0.0,2443,40207
199,16/9/2020,651371,296,399,39241,712,0,86,3,24,0.0,2446,40293
200,17/9/2020,651393,324,394,39195,713,0,89,5,27,0.0,2451,40382
201,18/9/2020,651423,337,393,39153,713,0,80,1,25,0.0,2452,40462
202,19/9/2020,651460,316,424,39105,714,0,71,4,28,0.0,2456,40533
203,20/9/2020,651490,324,417,39072,716,0,72,4,27,0.0,2460,40605
204,21/9/2020,651508,338,437,39020,716,0,101,4,30,0.0,2464,40706
205,22/9/2020,651544,330,436,38993,716,0,77,4,29,0.0,2468,40783
206,23/9/2020,651578,324,441,38959,717,0,73,6,33,0.0,2474,40856
207,24/9/2020,651623,304,440,38932,720,0,64,6,35,0.0,2480,40920
208,25/9/2020,651682,281,456,38878,722,0,52,3,36,0.0,2483,40972
209,26/9/2020,651747,256,467,38826,723,0,58,3,35,0.0,2486,41030
210,27/9/2020,651812,239,449,38795,724,0,54,3,30,0.0,2489,41084
211,28/9/2020,651870,238,437,38749,725,0,60,2,29,0.0,2491,41144
212,29/9/2020,651943,236,420,38695,725,0,56,2,31,0.0,2493,41200
213,30/9/2020,652039,231,395,38628,726,0,48,3,32,0.0,2496,41248
214,1/10/2020,652136,233,370,38551,729,0,62,4,30,0.0,2500,41310
215,2/10/2020,652208,238,355,38489,729,0,56,3,30,0.0,2503,41366
216,3/10/2020,652267,240,363,38415,734,0,65,11,34,0.0,2514,41431
217,4/10/2020,652358,247,354,38326,734,0,62,4,33,0.0,2518,41493
218,5/10/2020,652455,243,382,38205,734,0,66,3,35,0.0,2521,41559
219,6/10/2020,652558,238,396,38092,735,0,53,1,33,0.0,2522,41612
220,7/10/2020,652631,262,384,38006,736,0,75,2,30,0.0,2524,41687
221,8/10/2020,652721,267,377,37915,739,0,65,11,36,0.0,2535,41752
222,9/10/2020,652781,285,382,37832,739,0,87,8,41,0.0,2543,41839
223,10/10/2020,652870,282,399,37727,741,0,71,4,42,0.0,2547,41910
224,11/10/2020,652951,283,389,37654,742,0,61,4,42,0.0,2551,41971
225,12/10/2020,653020,289,401,37566,743,0,80,3,38,0.0,2554,42051
226,13/10/2020,653104,284,415,37473,743,0,73,8,41,0.0,2562,42124
227,14/10/2020,653192,290,429,37364,744,0,85,6,44,0.0,2568,42209
228,15/10/2020,653267,293,438,37277,744,0,83,2,44,0.0,2570,42292
229,16/10/2020,653350,312,428,37184,745,0,79,3,44,0.0,2573,42371
230,17/10/2020,653461,318,426,37064,750,0,79,3,37,0.0,2576,42450
231,18/10/2020,653533,309,447,36979,751,0,79,4,33,0.0,2580,42529
232,19/10/2020,653626,319,449,36870,755,0,79,2,27,0.0,2582,42608
233,20/10/2020,653707,332,444,36780,756,0,88,0,24,0.0,2582,42696
234,21/10/2020,653769,352,450,36693,755,0,99,3,25,0.0,2585,42795
235,22/10/2020,653827,365,444,36628,755,0,90,7,27,0.0,2592,42885
236,23/10/2020,653928,360,447,36528,756,0,83,5,28,0.0,2597,42968
237,24/10/2020,654050,347,452,36412,758,0,74,2,24,0.0,2599,43042
238,25/10/2020,654134,359,462,36305,759,0,106,1,24,0.0,2600,43148
239,26/10/2020,654242,364,456,36196,761,0,84,6,25,0.0,2606,43232
240,27/10/2020,654363,350,481,36062,763,0,80,1,24,0.0,2607,43312
241,28/10/2020,654440,350,504,35962,763,0,105,4,27,0.0,2611,43417
242,29/10/2020,654535,355,515,35851,763,0,97,5,31,0.0,2616,43514
243,30/10/2020,654596,373,501,35784,765,0,99,8,34,0.0,2624,43613
244,31/10/2020,654733,357,514,35649,766,0,72,2,32,0.0,2626,43685
245,1/11/2020,654836,362,493,35560,768,0,83,3,30,0.0,2629,43768
246,2/11/2020,654945,371,498,35435,770,0,102,2,27,0.0,2631,43870
247,3/11/2020,655012,369,505,35362,771,0,104,4,27,0.0,2635,43974
248,4/11/2020,655096,388,506,35256,773,0,109,5,29,0.0,2640,44083
249,5/11/2020,655178,407,511,35149,774,0,108,5,31,0.0,2645,44191
250,6/11/2020,655264,405,540,35034,776,0,96,3,32,0.0,2648,44287
251,7/11/2020,655382,410,559,34891,777,0,109,2,29,0.0,2650,44396
252,8/11/2020,655461,423,580,34776,779,0,120,8,33,0.0,2658,44516
253,9/11/2020,655555,437,578,34669,780,0,112,7,36,0.0,2665,44628
254,10/11/2020,655656,447,583,34550,783,0,118,4,33,0.0,2669,44746
255,11/11/2020,655744,465,593,34434,783,0,117,8,38,0.0,2677,44863
256,12/11/2020,655850,463,630,34292,784,0,127,3,36,0.0,2680,44990
257,13/11/2020,655944,453,647,34191,784,0,105,4,39,0.0,2684,45095
258,14/11/2020,655981,466,667,34119,786,0,134,5,37,0.0,2689,45229
259,15/11/2020,656051,509,657,34014,788,0,151,4,36,0.0,2693,45380
260,16/11/2020,656135,526,684,33885,789,0,146,1,30,0.0,2694,45526
261,17/11/2020,656207,524,700,33798,790,0,129,3,28,0.0,2697,45655
262,18/11/2020,656258,555,697,33719,790,0,142,5,29,0.0,2702,45797
263,19/11/2020,656311,578,726,33614,790,0,162,6,32,0.0,2708,45959
264,20/11/2020,656390,610,741,33487,791,0,158,3,33,0.0,2711,46117
265,21/11/2020,656455,604,755,33409,796,0,148,4,30,0.0,2715,46265
266,22/11/2020,656506,632,770,33315,796,0,179,5,33,0.0,2720,46444
267,23/11/2020,656567,642,788,33225,797,0,155,4,32,0.0,2724,46599
268,24/11/2020,656627,620,832,33141,799,0,152,9,37,0.0,2733,46751
269,25/11/2020,656622,673,874,33048,802,0,222,10,43,0.0,2743,46973
270,26/11/2020,656672,677,886,32978,806,0,173,7,45,0.0,2750,47146
271,27/11/2020,656674,724,916,32898,807,0,204,8,49,0.0,2758,47350
272,28/11/2020,656690,754,928,32839,808,0,194,9,53,0.0,2767,47544
273,29/11/2020,656689,790,961,32770,809,0,220,12,61,0.0,2779,47764
274,30/11/2020,656648,841,1008,32711,811,0,248,5,61,0.0,2784,48012
275,1/12/2020,656649,893,1023,32642,812,0,228,10,67,0.0,2794,48240
276,2/12/2020,653585,956,1074,32577,813,3014,276,10,64,0.0,2804,48516
277,3/12/2020,650480,1000,1142,32504,815,6078,265,5,63,0.0,2809,48781
278,4/12/2020,647427,1043,1171,32480,818,9080,274,4,58,0.0,2813,49055
279,5/12/2020,644343,1080,1236,32481,819,12060,302,9,58,0.0,2822,49357
280,6/12/2020,641287,1138,1286,32472,819,15017,311,5,58,0.0,2827,49668
281,7/12/2020,638217,1196,1346,32461,821,17978,331,9,56,0.0,2836,49999
282,8/12/2020,635078,1237,1421,32443,824,21016,329,6,58,0.0,2842,50328
283,9/12/2020,631908,1331,1494,32453,827,24006,373,12,64,0.0,2854,50701
284,10/12/2020,628772,1402,1573,32483,829,26960,382,10,67,0.0,2864,51083
285,11/12/2020,625634,1477,1657,32499,831,29921,394,19,78,0.0,2883,51477
286,12/12/2020,622475,1531,1777,32511,834,32891,424,10,83,0.0,2893,51901
287,13/12/2020,619338,1627,1863,32532,839,35820,449,13,89,0.0,2906,52350
288,14/12/2020,616194,1693,1984,32576,840,38732,467,13,93,0.0,2919,52817
289,15/12/2020,612887,1843,2031,32705,845,41708,529,16,92,0.0,2935,53346
290,16/12/2020,609572,1902,2154,32816,847,44728,514,15,96,0.0,2950,53860
291,17/12/2020,606164,2046,2258,32936,850,47765,588,17,105,0.0,2967,54448
292,18/12/2020,602797,2195,2356,33067,853,50751,591,9,99,0.0,2976,55039
293,19/12/2020,599455,2302,2466,33245,857,53694,611,16,106,0.0,2992,55650
294,20/12/2020,596015,2398,2611,33429,859,56707,639,24,112,0.0,3016,56289
295,21/12/2020,592544,2469,2814,33595,860,59737,673,15,118,0.0,3031,56962
296,22/12/2020,588992,2634,2963,33815,862,62753,750,18,124,0.0,3049,57712
297,23/12/2020,585463,2717,3104,34118,866,65751,715,28,134,0.0,3077,58427
298,24/12/2020,581843,2851,3241,34416,867,68801,783,22,144,0.0,3099,59210
299,25/12/2020,578199,3031,3397,34706,868,71818,835,20,157,0.0,3119,60045
300,26/12/2020,574568,3137,3588,35009,870,74847,827,21,156,0.0,3140,60872
301,27/12/2020,570864,3323,3761,35345,877,77849,932,22,164,0.0,3162,61804
302,28/12/2020,567251,3390,4021,35711,881,80765,893,29,169,0.0,3191,62697
303,29/12/2020,563483,3595,4184,36140,882,83735,1017,25,183,0.0,3216,63714
304,30/12/2020,559745,3781,4353,36553,888,86699,1009,33,197,0.0,3249,64723
305,31/12/2020,555919,3914,4511,37047,895,89733,1006,20,186,0.0,3269,65729
306,1/1/2021,552017,4047,4717,37583,902,92753,1082,33,193,0.0,3302,66811
307,2/1/2021,548074,4252,4928,38113,906,95746,1170,24,199,0.0,3326,67981
308,3/1/2021,544048,4535,5063,38720,910,98743,1232,34,216,0.0,3360,69213
309,4/1/2021,540095,4634,5289,39360,917,101724,1171,28,223,0.0,3388,70384
310,5/1/2021,535994,4811,5505,40035,920,104754,1267,27,223,0.0,3415,71651
311,6/1/2021,531888,4886,5776,40758,930,107781,1268,33,224,0.0,3448,72919
312,7/1/2021,527729,5003,6013,41536,934,110804,1323,35,232,0.0,3483,74242
313,8/1/2021,523488,5259,6193,42357,942,113780,1446,43,247,0.0,3526,75688
314,9/1/2021,519304,5408,6451,43161,953,116742,1439,38,257,0.0,3564,77127
315,10/1/2021,515002,5655,6712,43963,958,119729,1520,42,278,0.0,3606,78647
316,11/1/2021,510683,5836,6954,44848,961,122737,1513,53,302,0.0,3659,80160
317,12/1/2021,506212,6010,7248,45755,968,125826,1576,45,315,0.0,3704,81736
318,13/1/2021,501798,6103,7560,46703,975,128880,1569,43,332,0.0,3747,83305
319,14/1/2021,497453,6175,7750,47801,981,131859,1572,47,338,0.0,3794,84877
320,15/1/2021,493044,6228,8020,48866,992,134869,1602,50,347,0.0,3844,86479
