#time,date,susceptible,exposed,infectious,recovered,dead,immune,num infections today,num hospitalisations today,hospital bed occupancy,num hospitalisations today (data),cum num hospitalisations today,cum num infections today
1,2/3/2020,689504,1427,1128,801,1,0,446,3,14,0.0,3,446
2,3/3/2020,689020,1586,1307,947,1,0,484,4,15,0.0,7,930
3,4/3/2020,688442,1794,1505,1119,1,0,578,4,19,0.0,11,1508
4,5/3/2020,687779,2098,1669,1313,2,0,663,6,21,0.0,17,2171
5,6/3/2020,687100,2325,1881,1553,2,0,679,10,31,0.0,27,2850
6,7/3/2020,686367,2499,2192,1801,2,0,733,8,39,0.0,35,3583
7,8/3/2020,685424,2887,2429,2119,2,0,943,12,51,0.0,47,4526
8,9/3/2020,684335,3331,2720,2470,5,0,1089,7,52,0.0,54,5615
9,10/3/2020,683187,3789,3020,2859,6,0,1150,6,56,0.0,60,6765
10,11/3/2020,681889,4283,3367,3315,7,0,1298,19,73,0.0,79,8063
11,12/3/2020,680453,4769,3881,3750,8,0,1436,11,80,0.0,90,9499
12,13/3/2020,679388,4742,4436,4283,12,0,1065,29,99,0.0,119,10564
13,14/3/2020,678200,4771,4937,4940,13,0,1188,27,113,0.0,146,11752
14,15/3/2020,676825,5021,5335,5666,14,0,1375,22,130,0.0,168,13127
15,16/3/2020,675341,5243,5788,6472,17,0,1485,14,128,0.0,182,14612
16,17/3/2020,674237,5132,6120,7351,21,0,1104,28,146,0.0,210,15716
17,18/3/2020,672989,5102,6434,8312,24,0,1249,49,180,0.0,259,16965
18,19/3/2020,671751,5061,6685,9335,29,0,1239,29,195,0.0,288,18204
19,20/3/2020,670361,5204,6871,10392,33,0,1390,41,221,0.0,329,19594
20,21/3/2020,669302,5007,6956,11562,34,0,1060,36,248,0.0,365,20654
21,22/3/2020,668221,4825,7025,12747,43,0,1082,47,270,0.0,412,21736
22,23/3/2020,667210,4597,7101,13907,46,0,1011,54,304,0.0,466,22747
23,24/3/2020,666697,3928,7042,15143,51,0,513,56,337,0.0,522,23260
24,25/3/2020,666170,3358,6896,16376,61,0,527,65,353,0.0,587,23787
25,26/3/2020,665673,2827,6749,17543,69,0,497,57,378,0.0,644,24284
26,27/3/2020,665197,2432,6377,18774,81,0,476,81,422,0.0,725,24760
27,28/3/2020,664799,2112,5913,19943,94,0,398,58,431,0.0,783,25158
28,29/3/2020,664345,1997,5344,21067,108,0,454,74,456,0.0,857,25612
29,30/3/2020,663957,1873,4834,22078,119,0,388,61,474,0.0,918,26000
30,31/3/2020,663556,1775,4405,22992,133,0,401,56,475,0.0,974,26401
31,1/4/2020,663222,1659,4009,23818,153,0,334,59,482,0.0,1033,26735
32,2/4/2020,662928,1472,3707,24587,167,0,294,47,473,0.0,1080,27029
33,3/4/2020,662690,1309,3397,25284,181,0,238,65,480,0.0,1145,27267
34,4/4/2020,662427,1198,3154,25890,192,0,263,58,487,0.0,1203,27530
35,5/4/2020,662189,1111,2881,26475,205,0,238,43,465,0.0,1246,27768
36,6/4/2020,661948,1066,2653,26970,224,0,241,53,453,0.0,1299,28009
37,7/4/2020,661732,980,2475,27431,243,0,217,53,442,0.0,1352,28226
38,8/4/2020,661546,904,2268,27884,259,0,186,46,443,0.0,1398,28412
39,9/4/2020,661378,835,2094,28275,279,0,168,29,415,0.0,1427,28580
40,10/4/2020,661222,758,1960,28626,295,0,157,27,389,0.0,1454,28737
41,11/4/2020,661081,689,1807,28972,312,0,142,25,359,0.0,1479,28879
42,12/4/2020,660920,653,1701,29253,334,0,162,19,315,0.0,1498,29041
43,13/4/2020,660771,630,1540,29568,352,0,149,21,279,0.0,1519,29190
44,14/4/2020,660639,597,1430,29832,363,0,132,29,263,0.0,1548,29322
45,15/4/2020,660517,581,1296,30095,372,0,122,25,247,0.0,1573,29444
46,16/4/2020,660415,498,1264,30294,390,0,102,19,223,0.0,1592,29546
47,17/4/2020,660318,461,1176,30509,397,0,97,19,222,0.0,1611,29643
48,18/4/2020,660222,439,1078,30716,406,0,96,14,195,0.0,1625,29739
49,19/4/2020,660135,405,1020,30889,412,0,87,13,175,0.0,1638,29826
50,20/4/2020,660048,392,931,31066,424,0,87,15,158,0.0,1653,29913
51,21/4/2020,659965,371,840,31254,431,0,83,11,142,0.0,1664,29996
52,22/4/2020,659891,344,782,31408,436,0,74,10,130,0.0,1674,30070
53,23/4/2020,659842,294,734,31547,444,0,49,20,128,0.0,1694,30119
54,24/4/2020,659806,259,669,31675,452,0,36,5,110,0.0,1699,30155
55,25/4/2020,659763,227,625,31786,460,0,43,13,103,0.0,1712,30198
56,26/4/2020,659726,194,567,31912,462,0,37,7,97,0.0,1719,30235
57,27/4/2020,659690,186,499,32017,469,0,36,9,86,0.0,1728,30271
58,28/4/2020,659649,159,469,32114,470,0,41,4,80,0.0,1732,30312
59,29/4/2020,659611,161,413,32202,474,0,38,6,78,0.0,1738,30350
60,30/4/2020,659573,158,380,32271,479,0,38,7,71,0.0,1745,30388
61,1/5/2020,659546,151,335,32345,484,0,27,6,61,0.0,1751,30415
62,2/5/2020,659522,127,310,32415,487,0,24,4,53,0.0,1755,30439
63,3/5/2020,659502,109,292,32469,489,0,20,6,49,0.0,1761,30459
64,4/5/2020,659484,102,281,32503,491,0,19,7,52,0.0,1768,30478
65,5/5/2020,659471,91,266,32541,492,0,13,2,50,0.0,1770,30491
66,6/5/2020,659447,87,246,32586,495,0,24,5,43,0.0,1775,30515
67,7/5/2020,659429,89,205,32642,496,0,18,1,37,0.0,1776,30533
68,8/5/2020,659417,70,203,32673,498,0,12,5,38,0.0,1781,30545
69,9/5/2020,659393,77,186,32706,499,0,24,1,34,0.0,1782,30569
70,10/5/2020,659380,73,167,32741,500,0,13,2,32,0.0,1784,30582
71,11/5/2020,659371,61,144,32783,502,0,9,1,26,0.0,1785,30591
72,12/5/2020,659360,59,135,32805,502,0,12,1,24,0.0,1786,30603
73,13/5/2020,659347,54,129,32828,503,0,13,1,19,0.0,1787,30616
74,14/5/2020,659331,57,119,32851,503,0,16,2,16,0.0,1789,30632
75,15/5/2020,659319,55,109,32875,503,0,12,2,17,0.0,1791,30644
76,16/5/2020,659309,51,102,32893,506,0,11,4,17,0.0,1795,30655
77,17/5/2020,659297,46,103,32908,507,0,12,2,16,0.0,1797,30667
78,18/5/2020,659290,42,98,32923,508,0,7,1,15,0.0,1798,30674
79,19/5/2020,659278,42,91,32942,508,0,13,0,14,0.0,1798,30687
80,20/5/2020,659266,44,84,32959,508,0,13,1,14,0.0,1799,30700
81,21/5/2020,659255,46,84,32968,508,0,12,0,12,0.0,1799,30712
82,22/5/2020,659241,49,77,32986,508,0,14,1,10,0.0,1800,30726
83,23/5/2020,659230,48,76,32999,508,0,11,1,8,0.0,1801,30737
84,24/5/2020,659224,43,75,33011,508,0,6,0,6,0.0,1801,30743
85,25/5/2020,659214,43,72,33024,508,0,10,2,7,0.0,1803,30753
86,26/5/2020,659208,37,72,33036,508,0,7,1,8,0.0,1804,30760
87,27/5/2020,659194,46,70,33043,508,0,15,0,8,0.0,1804,30775
88,28/5/2020,659182,44,69,33058,508,0,12,0,7,0.0,1804,30787
89,29/5/2020,659172,40,70,33071,508,0,10,0,6,0.0,1804,30797
90,30/5/2020,659163,41,61,33088,508,0,10,0,5,0.0,1804,30807
91,31/5/2020,659159,34,62,33097,509,0,4,3,7,0.0,1807,30811
92,1/6/2020,659154,34,65,33099,509,0,5,1,8,0.0,1808,30816
93,2/6/2020,659145,27,75,33105,509,0,9,2,9,0.0,1810,30825
94,3/6/2020,659136,29,67,33120,509,0,9,1,10,0.0,1811,30834
95,4/6/2020,659131,26,62,33133,509,0,5,0,9,0.0,1811,30839
96,5/6/2020,659122,31,59,33140,509,0,11,1,9,0.0,1812,30850
97,6/6/2020,659114,32,56,33149,510,0,8,1,9,0.0,1813,30858
98,7/6/2020,659110,29,54,33158,510,0,5,1,9,0.0,1814,30863
99,8/6/2020,659100,37,48,33166,510,0,11,1,10,0.0,1815,30874
100,9/6/2020,659090,41,46,33173,511,0,10,0,7,0.0,1815,30884
101,10/6/2020,659086,32,50,33182,511,0,7,0,7,0.0,1815,30891
102,11/6/2020,659082,26,52,33189,512,0,5,1,6,0.0,1816,30896
103,12/6/2020,659071,30,53,33195,512,0,11,1,6,0.0,1817,30907
104,13/6/2020,659064,32,53,33199,513,0,8,0,5,0.0,1817,30915
105,14/6/2020,659059,30,54,33205,513,0,6,0,5,0.0,1817,30921
106,15/6/2020,659048,34,50,33216,513,0,12,1,5,0.0,1818,30933
107,16/6/2020,659039,38,48,33223,513,0,9,0,5,0.0,1818,30942
108,17/6/2020,659028,38,49,33233,513,0,11,1,5,0.0,1819,30953
109,18/6/2020,659021,40,45,33242,513,0,8,0,3,0.0,1819,30961
110,19/6/2020,659014,37,48,33249,513,0,7,1,4,0.0,1820,30968
111,20/6/2020,659005,35,53,33256,512,0,12,0,4,0.0,1820,30980
112,21/6/2020,659000,33,49,33267,512,0,7,1,5,0.0,1821,30987
113,22/6/2020,658993,36,45,33274,513,0,9,1,4,0.0,1822,30996
114,23/6/2020,658992,36,47,33272,514,0,8,0,3,0.0,1822,31004
115,24/6/2020,658990,32,53,33272,514,0,8,1,4,0.0,1823,31012
116,25/6/2020,658980,32,53,33282,514,0,10,2,5,0.0,1825,31022
117,26/6/2020,658969,38,50,33290,514,0,12,0,5,0.0,1825,31034
118,27/6/2020,658958,40,56,33293,514,0,15,0,5,0.0,1825,31049
119,28/6/2020,658952,45,51,33299,514,0,9,0,5,0.0,1825,31058
120,29/6/2020,658953,44,51,33299,514,0,6,0,5,0.0,1825,31064
121,30/6/2020,658945,50,48,33304,514,0,13,0,4,0.0,1825,31077
122,1/7/2020,658943,39,56,33309,514,0,6,3,6,0.0,1828,31083
123,2/7/2020,658932,37,59,33319,514,0,12,0,6,0.0,1828,31095
124,3/7/2020,658926,40,53,33328,514,0,8,0,5,0.0,1828,31103
125,4/7/2020,658921,40,53,33333,514,0,10,0,4,0.0,1828,31113
126,5/7/2020,658918,33,58,33337,515,0,7,0,3,0.0,1828,31120
127,6/7/2020,658907,41,57,33341,515,0,15,2,5,0.0,1830,31135
128,7/7/2020,658902,41,58,33345,515,0,9,0,5,0.0,1830,31144
129,8/7/2020,658894,45,54,33353,515,0,11,0,5,0.0,1830,31155
130,9/7/2020,658886,44,62,33354,515,0,13,1,6,0.0,1831,31168
131,10/7/2020,658878,43,65,33360,515,0,13,1,5,0.0,1832,31181
132,11/7/2020,658875,45,65,33361,515,0,12,0,5,0.0,1832,31193
133,12/7/2020,658870,46,66,33364,515,0,13,0,4,0.0,1832,31206
134,13/7/2020,658863,53,65,33365,515,0,13,0,4,0.0,1832,31219
135,14/7/2020,658854,59,65,33368,515,0,16,0,4,0.0,1832,31235
136,15/7/2020,658844,56,70,33375,516,0,14,0,3,0.0,1832,31249
137,16/7/2020,658838,59,71,33377,516,0,17,0,2,0.0,1832,31266
138,17/7/2020,658826,69,72,33378,516,0,24,0,2,0.0,1832,31290
139,18/7/2020,658810,85,68,33382,516,0,25,2,4,0.0,1834,31315
140,19/7/2020,658802,85,78,33380,516,0,20,2,6,0.0,1836,31335
141,20/7/2020,658794,82,86,33383,516,0,16,0,6,0.0,1836,31351
142,21/7/2020,658785,80,92,33388,516,0,16,1,7,0.0,1837,31367
143,22/7/2020,658776,83,94,33390,518,0,26,1,6,0.0,1838,31393
144,23/7/2020,658777,85,99,33382,518,0,21,0,6,0.0,1838,31414
145,24/7/2020,658771,82,106,33384,518,0,23,1,7,0.0,1839,31437
146,25/7/2020,658754,94,106,33388,519,0,32,0,5,0.0,1839,31469
147,26/7/2020,658731,104,118,33389,519,0,31,1,6,0.0,1840,31500
148,27/7/2020,658727,109,125,33381,519,0,25,1,6,0.0,1841,31525
149,28/7/2020,658706,113,133,33390,519,0,36,1,7,0.0,1842,31561
150,29/7/2020,658702,117,140,33381,521,0,28,1,6,0.0,1843,31589
151,30/7/2020,658694,110,146,33390,521,0,21,1,7,0.0,1844,31610
152,31/7/2020,658676,114,153,33397,521,0,33,3,9,0.0,1847,31643
153,1/8/2020,658677,113,163,33387,521,0,28,0,9,0.0,1847,31671
154,2/8/2020,658656,137,169,33378,521,0,46,1,10,0.0,1848,31717
155,3/8/2020,658659,128,174,33379,521,0,22,1,10,0.0,1849,31739
156,4/8/2020,658642,128,175,33395,521,0,33,0,9,0.0,1849,31772
157,5/8/2020,658624,129,169,33418,521,0,31,2,9,0.0,1851,31803
158,6/8/2020,658604,136,169,33430,522,0,36,0,7,0.0,1851,31839
159,7/8/2020,658599,133,167,33440,522,0,27,3,9,0.0,1854,31866
160,8/8/2020,658586,133,171,33449,522,0,35,0,7,0.0,1854,31901
161,9/8/2020,658577,136,171,33455,522,0,31,2,8,0.0,1856,31932
162,10/8/2020,658576,130,183,33449,523,0,34,2,9,0.0,1858,31966
163,11/8/2020,658584,127,184,33442,524,0,28,0,8,0.0,1858,31994
164,12/8/2020,658584,125,191,33436,525,0,30,1,8,0.0,1859,32024
165,13/8/2020,658579,126,183,33448,525,0,38,2,10,0.0,1861,32062
166,14/8/2020,658573,138,169,33455,526,0,34,2,10,0.0,1863,32096
167,15/8/2020,658554,153,173,33455,526,0,45,4,12,0.0,1867,32141
168,16/8/2020,658545,173,159,33458,526,0,48,4,16,0.0,1871,32189
169,17/8/2020,658523,178,176,33458,526,0,53,0,15,0.0,1871,32242
170,18/8/2020,658510,178,191,33454,528,0,41,1,13,0.0,1872,32283
171,19/8/2020,658477,188,211,33456,529,0,58,2,14,0.0,1874,32341
172,20/8/2020,658461,198,223,33449,530,0,55,3,15,0.0,1877,32396
173,21/8/2020,658427,214,233,33456,531,0,61,1,15,0.0,1878,32457
174,22/8/2020,658417,231,232,33450,531,0,58,0,11,0.0,1878,32515
175,23/8/2020,658386,242,254,33448,531,0,72,2,12,0.0,1880,32587
176,24/8/2020,658387,238,273,33432,531,0,54,2,12,0.0,1882,32641
177,25/8/2020,658376,244,279,33431,531,0,60,1,10,0.0,1883,32701
178,26/8/2020,658356,241,304,33429,531,0,67,2,10,0.0,1885,32768
179,27/8/2020,658340,267,297,33426,531,0,72,3,13,0.0,1888,32840
180,28/8/2020,658318,277,310,33425,531,0,70,4,16,0.0,1892,32910
181,29/8/2020,658326,248,343,33414,530,0,47,4,20,0.0,1896,32957
182,30/8/2020,658317,266,342,33406,530,0,75,6,25,0.0,1902,33032
183,31/8/2020,658302,264,342,33422,531,0,62,2,22,0.0,1904,33094
184,1/9/2020,658282,258,365,33424,532,0,67,2,22,0.0,1906,33161
185,2/9/2020,658274,271,359,33425,532,0,71,3,23,0.0,1909,33232
186,3/9/2020,658268,258,372,33431,532,0,57,4,26,0.0,1913,33289
187,4/9/2020,658292,242,376,33418,533,0,49,2,24,0.0,1915,33338
188,5/9/2020,658302,238,390,33395,536,0,58,4,25,0.0,1919,33396
189,6/9/2020,658312,242,382,33389,536,0,55,3,27,0.0,1922,33451
190,7/9/2020,658311,243,372,33397,538,0,62,2,26,0.0,1924,33513
191,8/9/2020,658298,265,364,33395,539,0,77,4,25,0.0,1928,33590
192,9/9/2020,658333,249,357,33381,541,0,49,1,22,0.0,1929,33639
193,10/9/2020,658341,256,361,33361,542,0,70,4,21,0.0,1933,33709
194,11/9/2020,658349,257,355,33356,544,0,72,4,22,0.0,1937,33781
195,12/9/2020,658360,259,351,33346,545,0,56,5,25,0.0,1942,33837
196,13/9/2020,658389,252,348,33326,546,0,52,6,29,0.0,1948,33889
197,14/9/2020,658411,247,364,33292,547,0,61,1,27,0.0,1949,33950
198,15/9/2020,658431,245,361,33277,547,0,60,3,29,0.0,1952,34010
199,16/9/2020,658434,248,359,33273,547,0,73,6,32,0.0,1958,34083
200,17/9/2020,658468,244,351,33249,549,0,52,1,30,0.0,1959,34135
201,18/9/2020,658464,254,347,33247,549,0,78,2,30,0.0,1961,34213
202,19/9/2020,658491,249,364,33207,550,0,59,3,30,0.0,1964,34272
203,20/9/2020,658513,275,367,33155,551,0,80,5,32,0.0,1969,34352
204,21/9/2020,658526,272,371,33139,553,0,68,5,29,0.0,1974,34420
205,22/9/2020,658546,289,369,33104,553,0,79,4,29,0.0,1978,34499
206,23/9/2020,658574,287,389,33057,554,0,69,2,28,0.0,1980,34568
207,24/9/2020,658580,278,385,33062,556,0,60,1,27,0.0,1981,34628
208,25/9/2020,658618,275,391,33020,557,0,58,2,27,0.0,1983,34686
209,26/9/2020,658678,250,392,32983,558,0,51,4,26,0.0,1987,34737
210,27/9/2020,658737,232,383,32949,560,0,40,2,23,0.0,1989,34777
211,28/9/2020,658802,204,374,32920,561,0,36,6,26,0.0,1995,34813
212,29/9/2020,658855,188,380,32877,561,0,48,7,30,0.0,2002,34861
213,30/9/2020,658900,193,364,32843,561,0,58,3,31,0.0,2005,34919
214,1/10/2020,658982,178,349,32789,563,0,34,2,29,0.0,2007,34953
215,2/10/2020,659032,185,337,32744,563,0,54,2,30,0.0,2009,35007
216,3/10/2020,659103,192,332,32671,563,0,50,3,30,0.0,2012,35057
217,4/10/2020,659162,177,335,32622,565,0,39,7,32,0.0,2019,35096
218,5/10/2020,659235,186,303,32570,567,0,50,5,31,0.0,2024,35146
219,6/10/2020,659292,200,289,32512,568,0,57,4,32,0.0,2028,35203
220,7/10/2020,659364,216,289,32424,568,0,55,3,30,0.0,2031,35258
221,8/10/2020,659436,210,296,32349,570,0,44,3,30,0.0,2034,35302
222,9/10/2020,659519,212,296,32264,570,0,56,5,33,0.0,2039,35358
223,10/10/2020,659575,211,302,32203,570,0,53,4,35,0.0,2043,35411
224,11/10/2020,659665,207,312,32107,570,0,43,4,38,0.0,2047,35454
225,12/10/2020,659762,205,305,32019,570,0,48,3,36,0.0,2050,35502
226,13/10/2020,659809,215,310,31956,571,0,70,2,34,0.0,2052,35572
227,14/10/2020,659895,233,306,31853,574,0,64,3,30,0.0,2055,35636
228,15/10/2020,659966,230,321,31769,575,0,61,4,30,0.0,2059,35697
229,16/10/2020,660051,221,330,31684,575,0,48,1,27,0.0,2060,35745
230,17/10/2020,660124,211,340,31610,576,0,61,4,27,0.0,2064,35806
231,18/10/2020,660189,234,330,31530,578,0,66,1,23,0.0,2065,35872
232,19/10/2020,660275,248,329,31430,579,0,71,1,22,0.0,2066,35943
233,20/10/2020,660381,249,312,31340,579,0,54,7,24,0.0,2073,35997
234,21/10/2020,660465,249,313,31255,579,0,53,4,24,0.0,2077,36050
235,22/10/2020,660559,239,321,31163,579,0,47,2,23,0.0,2079,36097
236,23/10/2020,660662,211,346,31062,580,0,42,3,22,0.0,2082,36139
237,24/10/2020,660760,206,356,30958,581,0,52,6,25,0.0,2088,36191
238,25/10/2020,660852,200,357,30870,582,0,49,3,27,0.0,2091,36240
239,26/10/2020,660967,194,353,30763,584,0,46,6,30,0.0,2097,36286
240,27/10/2020,661056,199,352,30669,585,0,61,4,27,0.0,2101,36347
241,28/10/2020,661163,218,330,30564,586,0,64,3,29,0.0,2104,36411
242,29/10/2020,661267,229,310,30467,588,0,57,2,26,0.0,2106,36468
243,30/10/2020,661375,228,315,30355,588,0,55,3,27,0.0,2109,36523
244,31/10/2020,661467,237,319,30248,590,0,65,4,27,0.0,2113,36588
245,1/11/2020,661547,227,343,30152,592,0,55,1,25,0.0,2114,36643
246,2/11/2020,661636,246,333,30053,593,0,77,1,24,0.0,2115,36720
247,3/11/2020,661720,256,326,29966,593,0,68,6,27,0.0,2121,36788
248,4/11/2020,661839,261,328,29839,594,0,61,4,28,0.0,2125,36849
249,5/11/2020,661913,264,336,29753,595,0,61,3,28,0.0,2128,36910
250,6/11/2020,662021,262,346,29636,596,0,64,2,26,0.0,2130,36974
251,7/11/2020,662113,274,356,29521,597,0,85,3,27,0.0,2133,37059
252,8/11/2020,662187,301,374,29402,597,0,96,4,28,0.0,2137,37155
253,9/11/2020,662256,330,367,29310,598,0,88,5,28,0.0,2142,37243
254,10/11/2020,662324,359,377,29203,598,0,96,4,26,0.0,2146,37339
255,11/11/2020,662418,361,390,29094,598,0,70,2,25,0.0,2148,37409
256,12/11/2020,662511,356,411,28985,598,0,83,1,23,0.0,2149,37492
257,13/11/2020,662599,363,448,28851,600,0,102,5,24,0.0,2154,37594
258,14/11/2020,662684,391,444,28742,600,0,106,6,28,0.0,2160,37700
259,15/11/2020,662786,387,451,28636,601,0,84,1,24,0.0,2161,37784
260,16/11/2020,662861,392,450,28553,605,0,90,5,24,0.0,2166,37874
261,17/11/2020,662932,403,469,28452,605,0,106,2,24,0.0,2168,37980
262,18/11/2020,663030,402,484,28340,605,0,101,2,24,0.0,2170,38081
263,19/11/2020,663114,389,513,28239,606,0,92,3,24,0.0,2173,38173
264,20/11/2020,663200,421,521,28113,606,0,121,4,26,0.0,2177,38294
265,21/11/2020,663262,438,532,28022,607,0,117,3,25,0.0,2180,38411
266,22/11/2020,663292,468,569,27925,607,0,143,5,28,0.0,2185,38554
267,23/11/2020,663303,516,571,27860,611,0,148,5,28,0.0,2190,38702
268,24/11/2020,663357,517,596,27780,611,0,119,5,32,0.0,2195,38821
269,25/11/2020,663397,531,628,27692,613,0,138,3,30,0.0,2198,38959
270,26/11/2020,663437,567,665,27579,613,0,155,7,35,0.0,2205,39114
271,27/11/2020,663465,598,696,27489,613,0,168,6,40,0.0,2211,39282
272,28/11/2020,663477,633,721,27417,613,0,176,5,41,0.0,2216,39458
273,29/11/2020,663486,643,770,27347,615,0,164,3,39,0.0,2219,39622
274,30/11/2020,663433,711,798,27302,617,0,219,9,44,0.0,2228,39841
275,1/12/2020,663406,761,835,27239,620,0,210,5,43,0.0,2233,40051
276,2/12/2020,660383,830,878,27170,622,2978,242,6,41,0.0,2239,40293
277,3/12/2020,657393,862,926,27104,624,5952,228,9,47,0.0,2248,40521
278,4/12/2020,654318,906,995,27076,626,8940,256,5,48,0.0,2253,40777
279,5/12/2020,651178,960,1069,27070,627,11957,279,9,50,0.0,2262,41056
280,6/12/2020,648100,1059,1115,27042,629,14916,310,10,55,0.0,2272,41366
281,7/12/2020,645006,1136,1182,27028,629,17880,323,6,55,0.0,2278,41689
282,8/12/2020,641878,1164,1274,27020,630,20895,321,4,53,0.0,2282,42010
283,9/12/2020,638726,1218,1362,27036,633,23886,336,9,54,0.0,2291,42346
284,10/12/2020,635533,1265,1465,27064,635,26899,347,7,54,0.0,2298,42693
285,11/12/2020,632396,1290,1561,27101,639,29874,333,6,55,0.0,2304,43026
286,12/12/2020,629149,1474,1625,27151,641,32821,481,7,52,0.0,2311,43507
287,13/12/2020,625978,1563,1737,27178,641,35764,424,12,58,0.0,2323,43931
288,14/12/2020,622757,1658,1827,27253,643,38723,461,14,68,0.0,2337,44392
289,15/12/2020,619328,1777,1937,27364,647,41808,516,15,73,0.0,2352,44908
290,16/12/2020,615982,1899,2059,27458,649,44814,535,12,74,0.0,2364,45443
291,17/12/2020,612552,2050,2161,27611,650,47837,588,18,88,0.0,2382,46031
292,18/12/2020,609153,2177,2296,27749,656,50830,591,18,93,0.0,2400,46622
293,19/12/2020,605706,2293,2485,27917,657,53803,642,24,111,0.0,2424,47264
294,20/12/2020,602259,2463,2616,28124,658,56741,688,21,127,0.0,2445,47952
295,21/12/2020,598724,2575,2786,28369,662,59745,692,18,137,0.0,2463,48644
296,22/12/2020,595124,2734,3006,28605,666,62726,802,12,132,0.0,2475,49446
297,23/12/2020,591521,2907,3187,28864,671,65711,803,23,143,0.0,2498,50249
298,24/12/2020,587786,3086,3380,29174,675,68760,866,26,155,0.0,2524,51115
299,25/12/2020,584039,3268,3577,29535,681,71761,930,21,154,0.0,2545,52045
300,26/12/2020,580185,3521,3752,29906,684,74813,972,30,165,0.0,2575,53017
301,27/12/2020,576413,3594,4020,30325,687,77822,931,27,178,0.0,2602,53948
302,28/12/2020,572607,3706,4291,30732,692,80833,1007,27,189,0.0,2629,54955
303,29/12/2020,568602,3998,4480,31228,698,83855,1159,27,200,0.0,2656,56114
304,30/12/2020,564663,4141,4701,31783,701,86872,1090,20,202,0.0,2676,57204
305,31/12/2020,560596,4310,4956,32329,709,89961,1167,24,195,0.0,2700,58371
306,1/1/2021,556481,4589,5132,32945,714,93000,1268,31,203,0.0,2731,59639
307,2/1/2021,552426,4779,5378,33568,719,95991,1254,33,210,0.0,2764,60893
308,3/1/2021,548340,4947,5629,34242,724,98979,1281,33,217,0.0,2797,62174
309,4/1/2021,544143,5117,5863,35000,727,102011,1333,29,226,0.0,2826,63507
310,5/1/2021,539940,5300,6022,35862,733,105004,1367,43,242,0.0,2869,64874
311,6/1/2021,535755,5393,6334,36630,737,108012,1345,29,250,0.0,2898,66219
312,7/1/2021,531552,5503,6613,37472,745,110976,1422,38,254,0.0,2936,67641
313,8/1/2021,527101,5694,6869,38396,757,114044,1536,35,256,0.0,2971,69177
314,9/1/2021,522706,5840,7120,39388,762,117045,1562,30,262,0.0,3001,70739
315,10/1/2021,518319,6104,7293,40398,773,119974,1632,46,266,0.0,3047,72371
316,11/1/2021,513809,6311,7529,41480,778,122954,1674,38,272,0.0,3085,74045
317,12/1/2021,509336,6401,7828,42564,787,125945,1635,50,290,0.0,3135,75680
318,13/1/2021,504822,6580,8103,43679,797,128880,1752,47,298,0.0,3182,77432
319,14/1/2021,500302,6698,8385,44811,804,131861,1708,52,323,0.0,3234,79140
320,15/1/2021,495666,6874,8575,46065,810,134871,1812,49,335,0.0,3283,80952
